house
10
10
false
0,0,0,0,0,0,0,0,0,0,
0,108,108,108,108,108,108,108,108,0,
0,108,108,108,108,108,108,108,108,0,
0,108,108,108,108,108,108,108,108,0,
0,108,108,108,108,108,108,108,108,0,
0,108,108,108,108,108,108,108,108,0,
0,108,108,108,108,108,108,108,108,0,
0,108,108,108,108,108,108,108,108,0,
0,108,108,108,108,108,108,108,108,0,
0,0,0,0,8,108,6,0,0,0
42,39,39,39,39,39,39,39,39,41,
24,106,0,0,0,0,0,0,0,22,
24,122,0,0,0,0,0,139,0,22,
24,0,0,0,0,0,0,0,0,22,
24,0,0,0,0,0,0,0,0,22,
24,0,0,0,0,0,0,0,0,22,
24,0,0,0,0,0,0,0,0,22,
24,0,0,0,0,0,0,0,0,22,
24,0,0,0,0,0,0,0,0,22,
26,7,7,7,41,0,42,7,7,25
0,0,0,0,0,0,0,107,0,0,
0,0,0,0,0,0,0,123,0,0,
0,0,0,0,0,0,0,0,0,0,
0,0,0,0,0,0,0,0,0,0,
0,0,0,0,0,0,0,0,0,0,
0,0,0,0,0,0,0,0,0,0,
0,0,0,0,0,0,0,0,0,0,
0,0,0,0,0,0,0,0,0,0,
0,0,0,0,0,0,0,0,0,0,
0,0,0,0,0,0,0,0,0,0
