House1
9
9
false
0,0,0,0,0,0,0,0,0,
0,108,108,108,108,108,108,108,0,
0,108,109,109,109,109,109,108,0,
0,108,109,14,108,14,109,108,0,
0,108,109,108,109,108,109,108,0,
0,108,109,14,108,14,109,108,0,
0,108,109,109,109,109,109,108,0,
0,108,108,14,14,14,108,108,0,
0,14,14,14,14,14,14,14,0
42,39,39,39,39,39,39,39,41,
24,0,0,0,0,0,0,0,22,
24,0,106,0,0,0,0,0,22,
24,0,122,0,0,0,139,0,22,
24,0,0,0,0,0,0,0,22,
24,0,0,0,0,0,0,0,22,
24,0,0,0,0,0,0,0,22,
24,0,0,0,0,0,0,0,22,
26,7,7,25,0,26,7,7,25
0,0,0,0,0,0,0,0,0,
0,0,0,0,0,0,107,0,0,
0,0,0,0,0,0,123,0,0,
0,0,0,0,0,0,0,0,0,
0,0,0,0,0,0,0,0,0,
0,0,0,0,0,0,0,0,0,
0,0,0,0,0,0,0,0,0,
0,0,0,0,0,0,0,0,0,
0,0,0,0,0,0,0,0,0

