TinyMap
24
24
2,2,2,2,2,2,2,2,2,2,2,2,2,2,2,2,2,2,2,2,2,2,2,2,
2,2,2,2,2,2,2,2,2,2,2,2,2,2,2,2,2,2,2,2,2,2,2,2,
2,2,3,4,4,4,4,4,4,4,4,4,4,4,4,5,2,2,2,2,2,2,2,2,
2,2,19,20,20,20,20,20,20,20,20,20,20,20,20,21,2,2,2,2,2,2,2,2,
2,2,19,20,20,20,20,20,20,20,20,20,20,20,20,21,2,2,2,2,2,2,2,2,
2,2,35,36,36,36,36,36,36,36,36,18,20,20,20,21,2,2,2,2,2,2,2,2,
2,2,2,2,2,2,2,2,2,2,2,35,18,20,20,21,2,2,2,2,2,2,2,2,
2,2,2,2,2,2,2,2,2,2,2,2,19,20,20,21,2,2,2,2,2,2,2,2,
2,2,2,2,2,2,2,2,2,2,2,2,19,20,20,21,2,2,2,2,2,2,2,2,
2,2,2,2,2,2,2,2,2,2,2,2,19,20,20,21,2,2,2,2,2,2,2,2,
2,2,2,2,2,2,2,2,2,2,2,2,19,20,20,21,2,2,2,2,2,2,2,2,
2,2,2,2,2,2,2,2,2,2,2,2,19,20,20,33,4,4,4,4,4,4,4,4,
2,2,2,2,2,2,2,2,2,2,2,2,19,20,20,20,20,20,20,20,20,20,20,20,
2,2,2,14,14,14,2,2,2,2,2,2,19,20,20,20,20,20,20,20,20,20,20,20,
2,2,2,14,14,14,2,2,2,2,2,2,19,20,20,20,20,20,20,20,20,20,20,20,
2,2,2,14,14,14,2,2,2,2,2,2,35,36,36,36,36,36,36,36,36,36,36,36,
2,2,2,2,2,2,2,2,2,2,2,2,2,2,2,2,2,2,2,2,2,2,2,2,
2,2,2,2,2,2,16,16,16,16,16,16,16,16,16,16,16,2,2,2,2,2,2,2,
2,2,2,2,2,2,16,16,16,16,16,16,16,16,16,16,16,2,2,2,2,2,2,2,
2,2,2,2,2,2,16,16,16,16,16,16,16,16,16,16,16,2,2,2,2,2,2,2,
2,2,2,2,2,2,2,2,2,2,2,2,2,2,2,2,13,13,13,2,2,2,2,2,
2,2,2,2,2,2,2,2,2,2,2,2,2,2,2,13,13,13,13,13,2,2,2,2,
2,2,2,2,2,2,2,2,2,2,2,2,2,2,13,13,13,13,13,13,2,2,2,2,
2,2,2,2,2,2,2,2,2,2,2,2,2,2,13,13,13,13,13,13,2,2,2,2
97,98,0,0,0,97,98,0,0,97,98,0,0,0,0,0,0,0,0,0,0,0,0,0,
113,114,0,0,0,113,114,0,0,113,114,0,0,0,0,0,0,0,0,0,0,0,0,0,
0,0,0,0,0,0,0,0,0,0,0,0,0,0,0,0,0,0,0,0,0,0,0,0,
0,0,0,0,0,0,0,0,0,0,0,0,0,0,0,0,0,0,0,0,0,0,0,0,
0,0,0,0,0,0,0,0,0,0,0,0,0,0,0,0,0,65,66,0,0,0,0,0,
97,98,0,0,0,0,0,0,0,0,0,0,0,0,0,0,0,81,82,0,0,0,0,0,
113,114,0,0,0,0,0,0,0,0,0,0,0,0,0,0,0,0,0,0,0,0,0,0,
0,0,0,0,0,0,0,0,0,0,0,0,0,0,0,0,0,97,98,0,0,0,0,0,
0,0,0,67,68,0,0,65,66,0,0,0,0,0,0,0,0,113,114,0,0,0,0,0,
0,0,0,83,84,0,0,81,82,0,0,0,0,0,0,0,58,59,61,0,65,66,0,0,
0,0,0,0,0,0,0,0,0,0,0,0,0,0,0,0,74,75,77,0,81,82,0,43,
0,97,98,0,0,0,0,0,0,0,0,0,0,0,0,0,90,91,93,0,0,0,0,0,
0,113,114,0,0,0,0,0,0,0,0,0,0,0,0,0,0,0,0,0,0,0,0,0,
0,0,0,0,0,0,0,0,0,0,0,0,0,27,0,0,0,0,0,0,0,0,0,0,
0,0,0,0,0,0,0,0,0,0,0,0,0,0,0,0,0,0,0,0,0,0,0,0,
0,0,0,0,0,0,0,65,66,0,0,0,0,0,0,0,0,0,0,0,0,0,0,0,
0,0,0,0,0,0,0,81,82,0,0,0,0,0,0,0,0,65,66,0,97,98,0,0,
0,0,97,98,0,0,0,0,0,0,0,0,0,0,0,0,0,81,82,0,113,114,0,0,
0,0,113,114,0,0,0,0,0,0,0,0,0,0,0,0,0,0,0,0,0,0,0,0,
0,0,0,0,0,0,0,0,0,0,0,0,0,0,0,0,0,0,0,0,0,0,0,0,
0,0,0,0,0,0,0,65,66,0,0,0,0,0,97,98,0,0,0,0,97,98,0,0,
0,0,0,0,0,0,0,81,82,0,0,0,0,0,113,114,6,9,8,0,113,114,0,0,
0,0,0,0,0,0,0,0,0,0,0,0,0,0,0,0,22,0,24,0,0,0,0,0,
0,0,0,0,0,0,0,0,0,0,0,0,0,0,0,0,38,39,40,0,0,0,0,0
0,0,0,0,0,0,0,0,0,0,0,0,0,0,0,0,0,0,0,0,0,0,0,0,
0,0,0,0,0,0,0,0,0,0,0,0,0,0,0,0,0,0,0,0,0,0,0,0,
0,0,0,0,0,0,0,0,0,0,0,0,0,0,0,0,0,0,0,0,0,0,0,0,
0,0,0,0,0,0,0,0,0,0,0,0,0,0,0,0,0,49,50,0,0,0,0,0,
0,0,0,0,0,0,0,0,0,0,0,0,0,0,0,0,0,65,66,0,0,0,0,0,
0,0,0,0,0,0,0,0,0,0,0,0,0,0,0,0,0,0,0,0,0,0,0,0,
0,0,0,0,0,0,0,0,0,0,0,0,0,0,0,0,0,0,0,0,0,0,0,0,
0,0,0,51,52,0,0,49,50,0,0,0,0,0,0,0,0,0,0,0,0,0,0,0,
0,0,0,67,68,0,0,65,66,0,0,0,0,0,0,0,0,0,0,0,49,50,0,0,
0,0,0,0,0,0,0,0,0,0,0,0,0,0,0,0,0,0,0,0,65,66,0,0,
0,0,0,0,0,0,0,0,0,0,0,0,0,0,0,0,0,0,0,0,0,0,0,0,
0,0,0,0,0,0,0,0,0,0,0,0,0,0,0,0,0,0,0,0,0,0,0,0,
0,0,0,0,0,0,0,0,0,0,0,0,0,0,0,0,0,0,0,0,0,0,0,0,
0,0,0,0,0,0,0,0,0,0,0,0,0,0,0,0,0,0,0,0,0,0,0,0,
0,0,0,0,0,0,0,49,50,0,0,0,0,0,0,0,0,0,0,0,0,0,0,0,
0,0,0,0,0,0,0,65,66,0,0,0,0,0,0,0,0,49,50,0,0,0,0,0,
0,0,0,0,0,0,0,0,0,0,0,0,0,0,0,0,0,65,66,0,0,0,0,0,
0,0,0,0,0,0,0,0,0,0,0,0,0,0,0,0,0,0,0,0,0,0,0,0,
0,0,0,0,0,0,0,0,0,0,0,0,0,0,0,0,0,0,0,0,0,0,0,0,
0,0,0,0,0,0,0,49,50,0,0,0,0,0,0,0,0,0,0,0,0,0,0,0,
0,0,0,0,0,0,0,65,66,0,0,0,0,0,0,0,0,0,0,0,0,0,0,0,
0,0,0,0,0,0,0,0,0,0,0,0,0,0,0,0,0,0,0,0,0,0,0,0,
0,0,0,0,0,0,0,0,0,0,0,0,0,0,0,0,0,0,0,0,0,0,0,0,
0,0,0,0,0,0,0,0,0,0,0,0,0,0,0,0,0,0,0,0,0,0,0,0
