Tiny Map
24
24
2,2,2,2,2,2,2,2,2,2,2,2,2,2,2,2,2,2,2,2,2,2,2,2,
2,2,2,2,2,2,2,2,2,2,2,2,2,2,2,2,2,2,2,2,2,2,2,2,
2,2,3,4,4,4,4,4,4,4,4,4,4,4,4,4,5,2,2,2,2,2,2,2,
2,2,19,20,20,20,20,20,20,20,20,20,20,20,20,20,21,2,2,2,2,2,2,2,
2,2,19,20,20,20,20,20,20,20,20,20,20,20,20,20,21,2,2,2,2,2,2,2,
2,2,35,36,36,36,36,36,36,36,36,18,20,20,20,20,21,2,2,2,2,2,2,2,
2,2,2,2,2,2,2,2,2,2,2,35,18,20,20,20,21,2,2,2,2,2,2,2,
2,2,2,2,2,2,2,2,2,2,2,2,19,20,20,20,21,2,2,2,2,2,2,2,
2,2,2,2,2,2,2,2,2,2,2,2,19,20,20,20,21,2,2,2,2,2,2,2,
2,2,2,2,2,2,2,2,2,2,2,2,19,20,20,20,21,2,2,2,2,2,2,2,
2,2,2,2,2,2,2,2,2,2,2,2,19,20,20,20,21,2,2,2,2,2,2,2,
2,2,2,2,2,2,2,2,2,2,2,2,19,20,20,20,4,4,4,4,4,4,4,4,
2,2,2,2,2,2,2,2,2,2,2,2,19,20,20,20,20,20,20,20,20,20,20,20,
2,2,2,2,2,2,2,2,2,2,2,2,19,20,20,20,20,20,20,20,20,20,20,20,
2,2,2,2,2,2,2,2,2,2,2,2,19,20,20,20,20,20,20,20,20,20,20,20,
2,2,2,2,2,2,2,2,2,2,2,2,19,20,20,20,20,20,20,20,20,20,20,20,
2,2,2,2,2,2,2,2,2,2,2,2,35,36,36,36,36,36,36,36,36,36,36,36,
2,2,2,2,2,2,2,2,2,2,2,2,2,2,2,2,2,2,2,2,2,2,2,2,
2,2,2,2,2,2,2,2,2,2,2,2,2,2,2,2,2,2,2,2,2,2,2,2,
2,2,2,2,2,2,2,2,2,2,2,2,2,2,2,2,2,2,2,2,2,2,2,2,
2,2,2,2,2,2,2,2,2,2,2,2,2,2,2,2,2,2,2,2,2,2,2,2,
2,2,2,2,2,2,2,2,2,2,2,2,2,2,2,2,2,2,2,2,2,2,2,2,
2,2,2,2,2,2,2,2,2,2,2,2,2,2,2,2,2,2,2,2,2,2,2,2,
2,2,2,2,2,2,2,2,2,2,2,2,2,2,2,2,2,2,2,2,2,2,2,2
97,98,0,0,0,97,98,0,0,97,98,0,0,0,0,0,0,0,0,0,0,0,0,0,
113,114,0,0,0,113,114,0,0,113,114,0,0,0,0,0,0,0,0,0,0,0,0,0,
0,0,0,0,0,0,0,0,0,0,0,0,0,0,0,0,0,0,0,0,0,0,0,0,
0,0,0,0,0,0,0,0,0,0,0,0,0,0,0,0,0,0,0,0,0,0,0,0,
0,0,0,0,0,0,0,0,0,0,0,0,0,0,0,0,0,65,66,0,0,0,0,0,
97,98,0,0,0,0,0,0,0,0,0,0,0,0,0,0,0,81,82,0,0,0,0,0,
113,114,0,0,0,0,0,0,0,0,0,0,0,0,0,0,0,0,0,0,0,0,0,0,
0,0,0,0,0,0,0,0,0,0,0,0,0,0,0,0,0,97,98,0,0,0,0,0,
0,0,0,67,68,0,0,65,66,0,0,0,0,0,0,0,0,113,114,0,0,0,0,0,
0,0,0,83,84,0,0,81,82,0,0,0,0,0,0,0,0,0,0,0,65,66,0,0,
0,0,0,0,0,0,0,0,0,0,0,0,0,0,0,0,0,0,0,0,81,82,0,0,
0,97,98,0,0,0,0,0,0,0,0,0,0,0,0,0,0,0,0,0,0,0,0,0,
0,113,114,0,0,0,0,0,0,0,0,0,0,0,0,0,0,0,0,0,0,0,0,0,
0,0,0,0,0,0,0,0,0,0,0,0,0,0,0,0,0,0,0,0,0,0,0,0,
0,0,0,0,0,0,0,0,0,0,0,0,0,0,0,0,0,0,0,0,0,0,0,0,
0,0,0,0,0,0,0,65,66,0,0,0,0,0,0,0,0,0,0,0,0,0,0,0,
0,0,0,0,0,0,0,81,82,0,0,0,0,0,0,0,0,0,0,0,0,0,0,0,
0,0,97,98,0,0,0,0,0,0,0,0,0,0,0,0,0,65,66,0,0,97,98,0,
0,0,113,114,0,0,0,0,0,0,0,0,0,0,0,0,0,81,82,0,0,113,114,0,
0,0,0,0,0,0,0,0,0,0,0,0,0,0,0,0,0,0,0,0,0,0,0,0,
0,0,0,0,0,0,0,65,66,0,0,0,0,0,97,98,0,0,0,0,97,98,0,0,
0,0,0,0,0,0,0,81,82,0,0,0,0,0,113,114,0,0,0,0,113,114,0,0,
0,0,0,0,0,0,0,0,0,0,0,0,0,0,0,0,0,0,0,0,0,0,0,0,
0,0,0,0,0,0,0,0,0,0,0,0,0,0,0,0,0,0,0,0,0,0,0,0
0,0,0,0,0,0,0,0,0,0,0,0,0,0,0,0,0,0,0,0,0,0,0,0,
0,0,0,0,0,0,0,0,0,0,0,0,0,0,0,0,0,0,0,0,0,0,0,0,
0,0,0,0,0,0,0,0,0,0,0,0,0,0,0,0,0,0,0,0,0,0,0,0,
0,0,0,0,0,0,0,0,0,0,0,0,0,0,0,0,0,49,50,0,0,0,0,0,
0,0,0,0,0,0,0,0,0,0,0,0,0,0,0,0,0,65,66,0,0,0,0,0,
0,0,0,0,0,0,0,0,0,0,0,0,0,0,0,0,0,0,0,0,0,0,0,0,
0,0,0,0,0,0,0,0,0,0,0,0,0,0,0,0,0,0,0,0,0,0,0,0,
0,0,0,51,52,0,0,49,50,0,0,0,0,0,0,0,0,0,0,0,0,0,0,0,
0,0,0,67,68,0,0,65,66,0,0,0,0,0,0,0,0,0,0,0,49,50,0,0,
0,0,0,0,0,0,0,0,0,0,0,0,0,0,0,0,0,0,0,0,65,66,0,0,
0,0,0,0,0,0,0,0,0,0,0,0,0,0,0,0,0,0,0,0,0,0,0,0,
0,0,0,0,0,0,0,0,0,0,0,0,0,0,0,0,0,0,0,0,0,0,0,0,
0,0,0,0,0,0,0,0,0,0,0,0,0,0,0,0,0,0,0,0,0,0,0,0,
0,0,0,0,0,0,0,0,0,0,0,0,0,0,0,0,0,0,0,0,0,0,0,0,
0,0,0,0,0,0,0,49,50,0,0,0,0,0,0,0,0,0,0,0,0,0,0,0,
0,0,0,0,0,0,0,65,66,0,0,0,0,0,0,0,0,0,0,0,0,0,0,0,
0,0,0,0,0,0,0,0,0,0,0,0,0,0,0,0,0,49,50,0,0,0,0,0,
0,0,0,0,0,0,0,0,0,0,0,0,0,0,0,0,0,65,66,0,0,0,0,0,
0,0,0,0,0,0,0,0,0,0,0,0,0,0,0,0,0,0,0,0,0,0,0,0,
0,0,0,0,0,0,0,49,50,0,0,0,0,0,0,0,0,0,0,0,0,0,0,0,
0,0,0,0,0,0,0,65,66,0,0,0,0,0,0,0,0,0,0,0,0,0,0,0,
0,0,0,0,0,0,0,0,0,0,0,0,0,0,0,0,0,0,0,0,0,0,0,0,
0,0,0,0,0,0,0,0,0,0,0,0,0,0,0,0,0,0,0,0,0,0,0,0,
0,0,0,0,0,0,0,0,0,0,0,0,0,0,0,0,0,0,0,0,0,0,0,0